13321111681119
13321111691118
13321111781119
13321111791118
13321111811196
13321111811197
13321111911186
13321111911187
13321116181119
13321116191118
13321116811191
13321116911181
13321117181119
13321117191118
13321117811191
13321117911181
13321161181119
13321161191118
13321161811191
13321161911181
13321171181119
13321171191118
13321171811191
13321171911181
13320181116119
13320181117119
13320181161119
13320181171119
13320181611119
13320181711119
13320191116118
13320191117118
13320191161118
13320191171118
13320191611118
13320191711118
13321611181119
13321611191118
13321611811191
13321611911181
13320681111119
13320691111118
13321711181119
13321711191118
13321711811191
13321711911181
13320781111119
13320791111118
13320811111196
13320811111197
13320811116191
13320811117191
13320811161191
13320811171191
13320811611191
13320811711191
13312111118691
13312111118791
13312111119681
13312111119781
13312111186911
13312111187911
13312111196811
13312111197811
13312116118191
13312116119181
13312116181911
13312116191811
13312117118191
13312117119181
13312117181911
13312117191811
13312161118191
13312161119181
13312161181911
13312161191811
13312171118191
13312171119181
13312171181911
13312171191811
13310181119116
13310181119117
13310181119161
13310181119171
13310181119611
13310181119711
13310191118116
13310191118117
13310191118161
13310191118171
13310191118611
13310191118711
13312611118191
13312611119181
13312611181911
13312611191811
13310681119111
13310691118111
13312711118191
13312711119181
13312711181911
13312711191811
13310781119111
13310791118111
13310811191116
13310811191117
13310811191161
13310811191171
13310811191611
13310811191711
13310811196111
13310811197111
13302118111691
13302118111791
13302118116191
13302118117191
13302118161191
13302118171191
13301118191116
13301118191117
13301118191161
13301118191171
13301118191611
13301118191711
13302118611191
13301118691111
13302118711191
13301118791111
13302119111681
13302119111781
13302119116181
13302119117181
13302119161181
13302119171181
13301119181116
13301119181117
13301119181161
13301119181171
13301119181611
13301119181711
13302119611181
13301119681111
13302119711181
13301119781111
13302181116911
13302181117911
13302181161911
13302181171911
13302181611911
13302181711911
13301181911116
13301181911117
13301181911161
13301181911171
13301181911611
13301181911711
13302186111911
13301186911111
13302187111911
13301187911111
13302191116811
13302191117811
13302191161811
13302191171811
13302191611811
13302191711811
13301191811116
13301191811117
13301191811161
13301191811171
13301191811611
13301191811711
13302196111811
13301196811111
13302197111811
13301197811111
