13321111113135
13321111113315
13321111123115
13321111131152
13321111131153
13321111131154
13321111131155
13321111131351
13321111133115
13321111133151
13321111143115
13321111153115
13321111213115
13321111231151
13321111311512
13321111311513
13321111311514
13321111311515
13321111311521
13321111311531
13321111311541
13321111311551
13321111313115
13321111313511
13321111331151
13321111331511
13321111413115
13321111431151
13321111513115
13321111531151
13321112113115
13321112131151
13321112311511
13321113113115
13321113131151
13321113311511
13321114113115
13321114131151
13321114311511
13321115113115
13321115131151
13321115311511
13321121113115
13321121131151
13321121311511
13321131113115
13321131131151
13321131311511
13321141113115
13321141131151
13321141311511
13321151113115
13321151131151
13321151311511
13321211113115
13321211131151
13321211311511
13321311113115
13321311131151
13321311311511
13321411113115
13321411131151
13321411311511
13321511113115
13321511131151
13321511311511
13312111114123
13312111114133
13312111114143
13312111114153
13312111114213
13312111114313
13312111114413
13312111114513
13312111134113
13312111141133
13312111141231
13312111141331
13312111141431
13312111141531
13312111142131
13312111143131
13312111144131
13312111145131
13312111314113
13312111341131
13312111411313
13312111411331
13312111412311
13312111413311
13312111414311
13312111415311
13312111421311
13312111431311
13312111441311
13312111451311
13312112114113
13312112141131
13312112411311
13312113114113
13310113115112
13310113115113
13310113115114
13310113115115
13310113115121
13310113115131
13310113115141
13310113115151
13310113115211
13310113115311
13310113115411
13310113115511
13310113135111
13312113141131
13310113315111
13312113411311
13312114114113
13312114141131
13312114411311
13312115114113
13312115141131
13312115411311
13312121114113
13312121141131
13312121411311
13310123115111
13312131114113
13312131141131
13310131151112
13310131151113
13310131151114
13310131151115
13310131151121
13310131151131
13310131151141
13310131151151
13310131151211
13310131151311
13310131151411
13310131151511
13310131152111
13310131153111
13310131154111
13310131155111
13310131351111
13312131411311
13310133115111
13310133151111
13312141114113
13312141141131
13312141411311
13310143115111
13312151114113
13312151141131
13312151411311
13310153115111
13312211114113
13312211141131
13312211411311
13310213115111
13310231151111
13312311114113
13312311141131
13312311411311
13310311511112
13310311511113
13310311511114
13310311511115
13310311511121
13310311511131
13310311511141
13310311511151
13310311511211
13310311511311
13310311511411
13310311511511
13310311512111
13310311513111
13310311514111
13310311515111
13310311521111
13310311531111
13310311541111
13310311551111
13310313115111
13310313511111
13310331151111
13310331511111
13312411114113
13312411141131
13312411411311
13310413115111
13310431151111
13312511114113
13312511141131
13312511411311
13310513115111
13310531151111
13301114113112
13301114113113
13301114113114
13301114113115
13301114113121
13301114113131
13301114113141
13301114113151
13301114113211
13301114113311
13301114113411
13301114113511
13301114123111
13301114133111
13301114143111
13301114153111
13301114213111
13301114313111
13301114413111
13301114513111
13301134113111
13301141131112
13301141131113
13301141131114
13301141131115
13301141131121
13301141131131
13301141131141
13301141131151
13301141131211
13301141131311
13301141131411
13301141131511
13301141133111
13301141231111
13301141331111
13301141431111
13301141531111
13301142131111
13301143131111
13301144131111
13301145131111
13301314113111
13301341131111
13301411311112
13301411311113
13301411311114
13301411311115
13301411311121
13301411311131
13301411311141
13301411311151
13301411311211
13301411311311
13301411311411
13301411311511
13301411313111
13301411331111
13301412311111
13301413311111
13301414311111
13301415311111
13301421311111
13301431311111
13301441311111
13301451311111
